111111111111111
1P00000000000E1
111101111110101
1C00010000000C1
101111011111101
1C00000000000C1
101011111110101
1C01000000000C1
100000000000001
111111111111111
