1111111
1P00001
1011101
1C00E01
1111111
